................................................
................................................
.....############....................#..........
.....................................#..........
.....................................#..........
.....................................#..........
.....................................#..........
.....................................#..........
...............############..........#..........
.....................................#..........
.....................................#..........
.....................................#..........
....#................................#..........
....#...........................................
....#...........................................
....#...........................................
....#...........................................
....#......................############.........
....#...........................................
....#...........................................
............................#...................
............................#...................
............................#...................
............................#...................
............................#...................
.............##.................................
.............##.................................
.............##...............##############....
.............##.................................
.............##.................................
.............##.................................
.............##...................##............
..................................##............
..................................##............
..................................##............
..................................##............
..................................##............
................................................
................................................
........................###########.............
................................................
..............#.................................
..............#.................................
..............#.................................
..............#....................###########..
..............#.................................
..............#.................................
................................................
