..#..........#..................#........#......
..............#.......#.....#......#.........#..
.................................#........#.....
....#...#.........#.......#...................#.
................................................
.........#..............#............#..........
#..................#...........................#
.....#.......#...............#..................
....................#...................#.......
.........#........................#...........#.
..#..........#..................#........#......
..............#.......#.....#......#.........#..
.................................#........#.....
....#...#.........#.......#...................#.
................................................
.........#..............#............#..........
#..................#...........................#
.....#.......#...............#..................
....................#...................#.......
.........#........................#...........#.
..#..........#..................#........#......
..............#.......#.....#......#.........#..
.................................#........#.....
....#...#.........#.......#...................#.
................................................
.........#..............#............#..........
#..................#...........................#
.....#.......#...............#..................
....................#...................#.......
.........#........................#...........#.
..#..........#..................#........#......
..............#.......#.....#......#.........#..
.................................#........#.....
....#...#.........#.......#...................#.
................................................
.........#..............#............#..........
#..................#...........................#
.....#.......#...............#..................
....................#...................#.......
.........#........................#...........#.
..#..........#..................#........#......
..............#.......#.....#......#.........#..
.................................#........#.....
....#...#.........#.......#...................#.
................................................
.........#..............#............#..........
#..................#...........................#
.....#.......#...............#..................
