################################################
...........#....................................
...........#....................................
...........#....................................
...........#....................................
................................................
....................................############
................................................
................................................
................................................
###############.................................
................................................
................................................
................######################..........
................#...............................
................#...............................
................#...............................
................##########......................
.........................#......................
.........................#......................
....###########..........#............#........
.........................#.............#........
.........................#............#.........
.........................#.............#........
.........................#............#.........
.......................................#........
......................................#.........
................................................
................................................
...............######################...........
................................................
................................................
.........................................#......
..........############...................#......
.........................................#......
.........................................#......
.........................................#......
.........................................#......
#........................................#......
#........................................#......
#...............................................
#...................#...........................
#...................#...........................
#...................#...........................
#...................#...........................
....................#...........................
....................#...........................
....................#...........................
